Abandon —– Forsake
Able —– Capable
Accomplish —– Achieve
Accurate —– Precise
Active —– Athletic
Admit —– Confess
Agree —– Consent
Aim —– Goal/ Purpose
Alike —– Same
All —– Every
Allow —– Permit
Amiable —– Friendly
Amount —– Quantity
Angry —– Mad/ Irritated
Arrive —– Reach
Ask —– Enquire
Assist —– Help
Assure —– Guarantee
Attire —– Dress
Away —– Absent
Awful —– Terrible/ Bad
Bargain —– Deal
Begin —– Start
Beginner —– Novice/ Amateur
Behave —– Act
Belly —– Stomach
Below —– Under
Big —– Vast/ Large
Blank —– Empty
Blend —– Mix
Bother —– Annoy
Brave —– Courageous
Broad —– Wide
Brute —– Rough/ Violent
Bucket —– Pail
Bunny —– Rabbit
Business —– Trade
Buy —– Purchase
Center —– Middle
Chiefly —– Mainly
Child —– Kid
Choose —– Select/ Pick
Chop —– Cut
Close —– Shut
Coat —– Jacket
Cold —– Chilly/ Freezing
Competent —– Capable
Complete —– Finish
Complex —– Complicated
Connect —– Join
Cope —– Manage
Couch —– Sofa
Coarse —– Rough
Crash —– Accident
Crook —– Criminal
Cry —– Weep
Cunning —– Clever
Danger —– Harm
Daybreak —– Dawn/ Sunrise
Dear —– Expensive
Defective —– Faulty
Delicious —– Yummy
Demolish —– Destroy/ Wreck
Demonstrate —– Protest
Denounce —– Blame/ Indict
Dense —– Thick/ Heavy
Depart —– Leave
Despise —– Hate/ Detest/ Loathe
Destiny —– Fate
Destitute —– Poor/ Penniless
Detach —– Remove
Deter —– Hinder
Determined —– Sure/ Convinced
Different —– Diverse
Difficult —– Hard
Diminish —– Decrease
Disappear —– Vanish
Disclose —– Reveal
Down —– Below
Earth —– Ground
Easy —– Simple
Encourage —– Urge
End —– Finish/ Conclude
Enlarge —– Magnify
Enormous —– Huge
Enquire —– Investigate
Evaluate —– Assess
Everlasting —– Eternal
Extra —– Additional
Faithful —– Loyal/ Devoted
Fall —– Drop
False —– Untrue
Famous —– Renowned
Fantastic —– Great
Fast —– Quick
Father —– Dad
Find —– Discover
Fix —– Repair/ Mend
Fool —– Idiot
Forbid —– Prohibit/ Ban
Forgive —– Pardon
Former —– Previous
Fraction —– Part/ Portion/ Segment
Fragrance —– Perfume
Frank —– Candid
Freedom —– Liberty
Frenzy —– Fury/ Rage
Fresh —– Unused/ New
Fun —– Enjoyment
Funny —– Amusing/ Entertaining
Furious —– Angry
Gain —– Acquire/ Obtain
Gallant —– Chivalrous
Garbage —– Trash/ Rubbish
Gather —– Collect
Gaunt —– Scrawny/ Skinny/ Thin
Gentle —– Tender
Gift —– Present
Glad —– Happy/ Pleased/ Delighted/ Cheerful/ Joyful/ Merry
Good —– Excellent
Great —– Grand
Hat —– Cap
Have —– Own/ Possess
Help —– Assist
Hot —– Boiling
House —– Home
Idea —– Thought
Important —– Significant
Infant —– Baby
Inspect —– Examine
Interesting —– Exciting
Job —– Occupation/ Work/ Career
Jungle —– Forest
Keep —– Hold
Kind —– Helpful
Last —– Final/ Ultimate
Late —– Tardy
Laugh —– Giggle
Learn —– Study
Like —– Love/ Enjoy/ Prefer
Listen —– Hear
Long —– Endless
Look —– Glance/ See/ Watch/ View
Loud —– Noisy
Lucky —– Fortunate
Many —– Numerous
Misery —– Distress/ Hardship
Mistake —– Error
Mix —– Stir/ Mingle/ Blend
Mother —– Mom
Naughty —– Mischievous
Nearly —– Almost
Neat —– Tidy
Occur —– Happen
Odd —– Strange/ Queer/ Weird
Old —– Ancient
Opportunity —– Chance
Outside —– Exterior
Page —– Sheet
Particular —– Specific
Pastime —– Hobby
Pause —– Hesitate
Perform —– Act/ Carry out
Place —– Put
Play —– Frolic
Polite —– Courteous
Popular —– Favorite
Precarious —– Uncertain/ Insecure
Pretty —– Beautiful
Prompt —– Immediate/ Instant
Pull —– Tug
Push —– Shove
Quake —– Tremble
Quiet —– Peaceful
Quiet —– Silent
Quite —– Fairly/ Pretty
Raise —– Lift
Real —– Genuine/ True
Receive —– Get
Regret —– Remorse
Reject —– Deny/ Refuse
Reliable —– Dependable/ Trustworthy
Remark —– Comment
Renew —– Resume
Rescue —– Save
Respect —– Honor
Respond —– Reply/ Answer
Rest —– Relax
Right —– Correct/ Proper/ True
Rich —– Wealthy
Round —– Circular
Rug —– Carpet
Rule —– Law
Sack —– Bag
Sad —– Unhappy
Say —– Tell/ Talk/ Speak
Scared —– Terrified/ Frightened/ Afraid
Shop —– Store
Shout —– Scream/ Yell
Shy —– Bashful/ Timid/ Embarrassed
Sick —– Ill
Sincere —– Honest
Slim —– Slender/ Thin
Small —– Little/ Tiny/ Diminutive
Smart —– Brilliant/ Intelligent/ Clever/ Bright
Smile —– Grin
Sniff —– Smell
Sordid —– Dirty
Speech —– Lecture
Split —– Divide
Spooky —– Scary/ Creepy
Sprint —– Run
Stone —– Rock
Story —– Tale
Suggest —– Propose
Sundown —– Sunset
Sure —– Certain
Talkative —– Communicative
Taxi —– Cab
Temper —– Mood
Thankful —– Grateful
Think —– Ponder/ Consider
Toss —– Throw
Total —– Entire/ Whole
Transform —– Convert
Trip —– Journey
Trust —– Believe
Try —– Attempt
Uncommon —– Unusual
Uncooked —– Raw
Uneasy —– Restless/ Concerned/ Nervous/ Anxious
Unfortunate —– Unlucky
Unlawful —– Illegal
Unmarried —– Single
Usually —– Generally
Value —– Worth
Very —– Extremely
Walk —– Stroll
Want —– Desire
Weak —– Feeble
Winner —– Victor
Woman —– Lady
Wonderful —– Amazing
Word —– Expression
Write —– Record
Writer —– Author
Wrong —– Incorrect
Yearly —– Annually
